# gep_len: 5
# 表示多关键词规则中关键词生效的最大间隔
#
# rule_score: 0.3
# 表示规则命中后的加分
#
# 支持正则，注意字符转义。example：
# word1 word2	label1 label2
风水	文化生活
风水	文化生活 房产家居
书画	文化生活
收藏	文化生活
儒学	文化生活
佛学	文化生活
道学	文化生活
月关	文化生活
辰东	文化生活
宠物	文化生活
狗狗	文化生活
猫咪	文化生活
生活 技巧	文化生活
养猫	文化生活
养狗	文化生活
哈士奇	文化生活
二哈	文化生活
睿士	时尚
高跟鞋	时尚
yeezy	时尚
adidas	时尚
nike	时尚
air jordan	时尚
男鞋	时尚
休闲鞋	时尚
burberry	时尚
巴宝莉	时尚
阿玛尼	时尚
ysl	时尚
爱马仕	时尚
宝宝	时尚
搭配 时尚	时尚
男装	时尚
机械表	时尚
机械 手表	时尚
机械 机芯	时尚
光动能	时尚
饰品	时尚
护肤	时尚 健康
发型	时尚
美妆	时尚
彩妆	时尚
化妆	时尚
底妆	时尚
形象设计	时尚
穴位	健康
丰胸	健康
祛痘	健康
治疗	健康
中医	健康
医学	健康
两性	健康 情感 搞笑
糗事	搞笑
全场 笑	搞笑
小品	搞笑
相声	搞笑
笑多了	搞笑
笑 胃疼	搞笑
笑 疯	搞笑
笑 抽筋	搞笑
笑 翻天	搞笑
笑 神经	搞笑
女神经	搞笑
整蛊	搞笑
环道接力赛 老司机	搞笑
笑料百出	搞笑
男女 交往	情感
心理学	情感
星座	情感
恋爱	情感
婚姻 情感	情感
学做 女人	情感
涂磊	情感
大排档	美食
烘焙	美食
大胃王	美食
直播 吃饭	美食
直播 吃	美食
吃播	美食
吃秀	美食
吃法	美食
木下	美食
下饭	美食
美味	美食
蛋糕	美食
红酒	美食
吃货	美食
好吃	美食
做法 大全	美食
菜谱	美食
家常菜	美食
快餐	美食
火锅	美食
必胜客	美食
麦当劳	美食
星巴克	美食
dlc	游戏
主机版	游戏
sd 高达	游戏
机动 高达	游戏
音游	游戏
手游	游戏
手机游戏	游戏
qq飞车	游戏
守望先锋	游戏
全场最佳	游戏
休闲 游戏	游戏
我的世界	游戏
战舰世界	游戏
方舟 起源	游戏
英雄联盟	游戏
魔兽争霸	游戏
穿越火线	游戏
解说 期	游戏
解说 实况	游戏
解说 轮	游戏
lol	游戏
pdd	游戏
阿怡	游戏
小漠	游戏
小智	游戏
直播 草莓	游戏
直播 笑笑	游戏
edg	游戏
csgo	游戏
中单	游戏
上单	游戏
打野	游戏
五五开	游戏
文森特	游戏
德云色	游戏
网咖	游戏
电竞	游戏
电子竞技	游戏
刀塔传奇	游戏
王者荣耀	游戏
荣耀日常录	游戏
uzi	游戏
faker	游戏
skt	游戏
跑跑卡丁车	游戏
皮城	游戏
作战	游戏
诛仙	游戏
carry	游戏
gank	游戏
越塔	游戏
发姐	游戏
陈一发	游戏
h1z1	数码
gtr	汽车
东风	汽车
宝骏	汽车
观致	汽车
奇瑞	汽车
比亚迪	汽车
byd	汽车
江淮	汽车
别克	汽车
4s店	汽车
奔驰	汽车
福特	汽车
奥迪	汽车
法拉利	汽车
超跑	汽车
广汽	汽车
车险	汽车
汽车用品	汽车
特斯拉	汽车 科技
无人机	科技
发明	科技
黑客	科技
机器人	科技
小米	数码 科技
索尼	数码
主板	数码
拆机	数码
拆解	数码
新机	数码
魅族	数码
一加	数码
红米	数码
oppo	数码
vivo	数码
努比亚	数码
奇酷	数码
音响	数码
锤子 罗永浩	数码
锤子 老罗	数码
锤子 发布会	数码
锤子 体验	数码
锤子 系统	数码
锤子 工匠	数码
骁龙	数码
moto	数码
macbook	数码
surface	数码
airpods	数码
官换机	数码
gopro	数码
apple watch	数码
智能 手表	数码
移动电源	数码
充电宝	数码
kindle	数码
台式机	数码
魅蓝	数码
极路由	数码
路由器	数码
PS4	数码
windows	数码
技嘉	数码
华硕	数码
微星	数码
显卡	数码
电脑主机	数码
电脑 主机	数码
游戏 主机	数码
水冷	数码
油冷	数码
显示器	数码
安卓	数码
序列号 查询	数码
交警	社会资讯
冷 降温	社会资讯
降雪	社会资讯
便民服务	社会资讯
法律 知识	社会资讯
交通事故	社会资讯
特朗普	社会资讯
动漫	娱乐
新番	娱乐
后援会	娱乐
吴昕	娱乐
大鹏	娱乐
言承旭	娱乐
exo	娱乐
bigbang	娱乐
snh48	娱乐
华晨宇	娱乐
李荣浩	娱乐
侧田	娱乐
二次元	娱乐
岳云鹏	娱乐
王自健	娱乐
王子文	娱乐
孔侑	娱乐
琅琊榜	娱乐
芈月	娱乐
神曲	娱乐
童星	娱乐
林妙可	娱乐
杨幂	娱乐
郑爽	娱乐
蒋欣	娱乐
刘诗诗	娱乐
赵丽颖	娱乐
刘涛	娱乐
宋佳	娱乐
吴京	娱乐
卷福	娱乐
杨澜	娱乐
朱丹	娱乐
胡歌	娱乐
金莎	娱乐
朱之文	娱乐
陈伟霆	娱乐
胡歌	娱乐
李小璐	娱乐
angelababy	娱乐
薛之谦	娱乐
李晨	娱乐
范冰冰	娱乐
陈赫	娱乐
邓超	娱乐
孙俪	娱乐
何洁	娱乐
刘德华	娱乐
陈奕迅	娱乐
杨洋	娱乐
李易峰	娱乐
王俊凯	娱乐
马伊琍	娱乐
大张伟	娱乐
贾乃亮	娱乐
谢霆锋	娱乐
张柏芝	娱乐
娜美	娱乐
小李子	娱乐
权志龙	娱乐
鹿晗	娱乐
张艺兴	娱乐
黄子韬	娱乐
宅舞	娱乐
强迫症	娱乐
张无忌	娱乐
步惊云	娱乐
聂风	娱乐
华妃	娱乐
网红	娱乐
拍戏	娱乐
吻戏	娱乐
yy 直播	娱乐
直播 跳舞	娱乐
老歌	娱乐
冲关	娱乐
阿宝 义演	娱乐
cosplay	娱乐
cos	娱乐
tvb	娱乐
广场舞	娱乐
九阳神功	娱乐
黑客帝国	娱乐
凤凰传奇	娱乐
片尾曲	娱乐
感动 全场	娱乐
震撼 全场	娱乐
嗨翻 全场	娱乐
耳朵 怀孕	娱乐
mba	教育
家庭教育	教育
培训 招生	教育
高考	教育
公务员 考试	教育
公务员 面试	教育
公考	教育
儿童 心理学	育儿
母婴	育儿
亲子	育儿
辣妈	育儿
小宝宝	育儿
妈妈 宝宝	育儿
小猪佩琪	育儿
高考 培训	教育
四六级	教育
球员	体育运动
球星	体育运动
科比	体育运动
宁泽涛	体育运动
nba 体育运动
cba 体育运动
中超	体育运动
西甲	体育运动
英超	体育运动
德甲	体育运动
亚冠	体育运动
意甲	体育运动
法甲	体育运动
国安	体育运动
田亮	体育运动
王楠	体育运动
林丹	体育运动
申花	体育运动
曼联	体育运动
体彩	体育运动
大奖赛	体育运动
武术	体育运动
运动员	体育运动
格斗	体育运动
信托	财经
私募	财经
期货	财经
妖股	财经
牛股	财经
涨停	财经
散户	财经
股民	财经
货币	财经
华尔街	财经
致富	财经
物业	房产家居
楼市	房产家居
房地产	房产家居
装饰	房产家居
装修 设计 房产家居
家居 设计	房产家居
家具	房产家居
风景区	旅游摄影
儿童摄影	旅游摄影
一日游	旅游摄影
云计算	互联网
虎嗅	互联网
互联网 信贷	互联网
董明珠	互联网
格力	互联网
刘强东	互联网
李彦宏	互联网
马化腾	互联网
python	互联网
c\+\+	互联网
c语言	互联网
html5	互联网
大 数据	互联网
数据库	互联网
excel	互联网
javascript	互联网
cad	互联网
java	互联网
运维	互联网
机器学习	互联网
深度学习	互联网
罗永浩	互联网
运势	情感
星座	情感
白羊座	情感
金牛座	情感
双子座	情感
巨蟹座	情感
巨蟹	情感
狮子座	情感
天平座	情感
天秤座	情感
天秤	情感
天蝎座	情感
天蝎	情感
射手座	情感
摩羯座	情感
摩羯	情感
水瓶座	情感
双鱼座	情感
双鱼	情感
互联网金融	财经
电子商务	互联网
O2O	互联网
搜索引擎	互联网
社交网络	互联网
Facebook	互联网
物联网	互联网
皮肤病	健康
传染病	健康
妇科	健康
癌症	健康
口腔护理	健康
养肾	健康
保健品	健康
亲子成长	育儿
孕产	育儿
健康护理	育儿
儿童教育	育儿
花絮	娱乐
c罗	体育运动
伊布	体育运动
刘翔	体育运动
卡卡	体育运动
古力	体育运动
姚明	体育运动
张帅	体育运动
李娜	体育运动
林丹	体育运动
梅西	体育运动
欧文	体育运动
科比	体育运动
郭跃	体育运动
马龙	体育运动
丁俊晖	体育运动
内马尔	体育运动
刘诗雯	体育运动
卡罗尔	体育运动
史鸿飞	体育运动
吴清源	体育运动
哈达迪	体育运动
宁泽涛	体育运动
官秀昌	体育运动
张怡宁	体育运动
张玉宁	体育运动
张琳芃	体育运动
张继科	体育运动
易建联	体育运动
李世石	体育运动
李昌镐	体育运动
杜兰特	体育运动
林书豪	体育运动
格里芬	体育运动
王适娴	体育运动
田厚威	体育运动
福原爱	体育运动
聂卫平	体育运动
詹姆斯	体育运动
郭艾伦	体育运动
黑嘉嘉	体育运动
石川佳纯	体育运动
穆里尼奥	体育运动
莎拉波娃	体育运动
贝克汉姆	体育运动
德约科维奇	体育运动
莱万多夫斯基	体育运动
a-lin	娱乐
angelababy	娱乐
exo	娱乐
selina	娱乐
tfboys	娱乐
v字仇杀队	娱乐
x战警	娱乐
小s	娱乐
乐嘉	娱乐
何炅	娱乐
倪妮	娱乐
倪萍	娱乐
关悦	娱乐
刘涛	娱乐
刘雯	娱乐
华少	娱乐
叶问	娱乐
周涛	娱乐
唐嫣	娱乐
大鹏	娱乐
姚晨	娱乐
孙俪	娱乐
孟非	娱乐
宋茜	娱乐
寒战	娱乐
左溢	娱乐
张杰	娱乐
张磊	娱乐
弦子	娱乐
成龙	娱乐
戚薇	娱乐
戴荃	娱乐
无极	娱乐
曹颖	娱乐
朱迅	娱乐
朴树	娱乐
李健	娱乐
李安	娱乐
李晟	娱乐
李晨	娱乐
李湘	娱乐
李玟	娱乐
杨幂	娱乐
林允	娱乐
柳岩	娱乐
欧弟	娱乐
汪峰	娱乐
汪涵	娱乐
沈腾	娱乐
王杰	娱乐
王菲	娱乐
胡歌	娱乐
苏芒	娱乐
萱萱	娱乐
董卿	娱乐
蚁人	娱乐
许巍	娱乐
许晴	娱乐
诡娃	娱乐
谢娜	娱乐
赵薇	娱乐
邓超	娱乐
那英	娱乐
郑恺	娱乐
郑爽	娱乐
陈坤	娱乐
陈翔	娱乐
陈赫	娱乐
霍尊	娱乐
靳东	娱乐
韩红	娱乐
鹿晗	娱乐
龙宽	娱乐
教父1	娱乐
功夫2	娱乐
叶问3	娱乐
致命id	娱乐
西游·降魔篇	娱乐
七宗罪	娱乐
于建嵘	娱乐
于朦胧	娱乐
井柏然	娱乐
佟丽娅	娱乐
佟大为	娱乐
俞灏明	娱乐
僵尸侠	娱乐
全智贤	娱乐
关晓彤	娱乐
关诗敏	娱乐
刘亦菲	娱乐
刘德华	娱乐
刘思涵	娱乐
刘恺威	娱乐
刘明湘	娱乐
刘芳菲	娱乐
刘若英	娱乐
刘诗诗	娱乐
华晨宇	娱乐
卓依婷	娱乐
发条橙	娱乐
古天乐	娱乐
史泰龙	娱乐
史玉柱	娱乐
吴世勋	娱乐
吴亦凡	娱乐
吴奇隆	娱乐
吴宗宪	娱乐
吴秀波	娱乐
周星驰	娱乐
周杰伦	娱乐
周润发	娱乐
周立波	娱乐
周笔畅	娱乐
呼斯楞	娱乐
哑孩儿	娱乐
唐艺昕	娱乐
夏奇拉	娱乐
大白鲨	娱乐
大逃杀	娱乐
央吉玛	娱乐
女超人	娱乐
姚贝娜	娱乐
孙燕姿	娱乐
孙骁骁	娱乐
宋仲基	娱乐
宋小宝	娱乐
宋慧乔	娱乐
宋承宪	娱乐
宋智孝	娱乐
宋祖英	娱乐
宋钟基	娱乐
容祖儿	娱乐
小时代	娱乐
尹恩惠	娱乐
崔永元	娱乐
布兰妮	娱乐
开心鬼	娱乐
张信哲	娱乐
张含韵	娱乐
张国荣	娱乐
张大大	娱乐
张天爱	娱乐
张娜拉	娱乐
张学友	娱乐
张恒远	娱乐
张惠妹	娱乐
张智霖	娱乐
张曼玉	娱乐
张柏芝	娱乐
张梓琳	娱乐
张歆艺	娱乐
张泉灵	娱乐
张泽群	娱乐
张碧晨	娱乐
张绍刚	娱乐
张艺兴	娱乐
张钧甯	娱乐
张雨绮	娱乐
张靓颖	娱乐
张馨予	娱乐
彭丽媛	娱乐
徐佳莹	娱乐
撒贝宁	娱乐
曲婉婷	娱乐
曹可凡	娱乐
曹德旺	娱乐
朴信惠	娱乐
朴宝英	娱乐
朴海镇	娱乐
机械师	娱乐
杀破狼	娱乐
权志龙	娱乐
李亚鹏	娱乐
李修平	娱乐
李克勤	娱乐
李嘉格	娱乐
李宇春	娱乐
李小龙	娱乐
李幸倪	娱乐
李思思	娱乐
李敏镐	娱乐
李文琦	娱乐
李易峰	娱乐
李治廷	娱乐
李玲玉	娱乐
李祥祥	娱乐
李维嘉	娱乐
李荣浩	娱乐
李菲儿	娱乐
李连杰	娱乐
李钟硕	娱乐
杜海涛	娱乐
杨钰莹	娱乐
极盗者	娱乐
林俊杰	娱乐
林允儿	娱乐
林心如	娱乐
林志玲	娱乐
林志颖	娱乐
林正英	娱乐
梁君诺	娱乐
梁宏达	娱乐
梁静茹	娱乐
梅兰芳	娱乐
梅艳芳	娱乐
毕福剑	娱乐
毛泽少	娱乐
沈梦辰	娱乐
洛丽塔	娱乐
火柴人	娱乐
熊黛林	娱乐
独立日	娱乐
狼少年	娱乐
王力宏	娱乐
王小丫	娱乐
王祖蓝	娱乐
王自健	娱乐
甄子丹	娱乐
田馥甄	娱乐
白举纲	娱乐
白夜行	娱乐
白岩松	娱乐
白方礼	娱乐
白鹿原	娱乐
碧昂丝	娱乐
禁闭岛	娱乐
秦宇子	娱乐
精武门	娱乐
绿巨人	娱乐
绿灯侠	娱乐
罗志祥	娱乐
美人图	娱乐
美人鱼	娱乐
老炮儿	娱乐
耿斯汉	娱乐
胡冰卿	娱乐
胡维纳	娱乐
艾薇儿	娱乐
芮成钢	娱乐
范世琦	娱乐
范冰冰	娱乐
范晓萱	娱乐
范玮琪	娱乐
萨顶顶	娱乐
董文华	娱乐
蒋劲夫	娱乐
蔡依林	娱乐
蔡康永	娱乐
蕾哈娜	娱乐
薛之谦	娱乐
蜘蛛侠	娱乐
裴秀智	娱乐
谢彬彬	娱乐
谢霆锋	娱乐
谭咏麟	娱乐
谭维维	娱乐
赵丽颖	娱乐
赵大格	娱乐
赵忠祥	娱乐
赵本山	娱乐
邓丽君	娱乐
邓紫棋	娱乐
郑渊洁	娱乐
郑秀妍	娱乐
郑秀晶	娱乐
郭富城	娱乐
郭德纲	娱乐
郭明义	娱乐
郭碧婷	娱乐
金刚狼	娱乐
金巧巧	娱乐
金志文	娱乐
金智媛	娱乐
金泫雅	娱乐
金秀贤	娱乐
金钟国	娱乐
钟欣桐	娱乐
钟汉良	娱乐
钱泳辰	娱乐
锦衣卫	娱乐
阚立文	娱乐
阿凡达	娱乐
阿黛尔	娱乐
陈乐基	娱乐
陈乔恩	娱乐
陈伟霆	娱乐
陈光标	娱乐
陈冠希	娱乐
陈奕迅	娱乐
陈学冬	娱乐
陈小春	娱乐
陈慧娴	娱乐
陈梓童	娱乐
陈永馨	娱乐
霍建华	娱乐
霜花店	娱乐
鞠婧祎	娱乐
马伊琍	娱乐
马吟吟	娱乐
马天宇	娱乐
高圆圆	娱乐
麦当娜	娱乐
黄子韬	娱乐
黄家驹	娱乐
黄晓明	娱乐
黄飞鸿	娱乐
龚玥菲	娱乐
迈克尔 杰克逊	娱乐
上海大学	教育
东南大学	教育
中南大学	教育
中山大学	教育
云南大学	教育
兰州大学	教育
北京大学	教育
南京大学	教育
南开大学	教育
厦门大学	教育
吉林大学	教育
同济大学	教育
四川大学	教育
复旦大学	教育
天津大学	教育
山东大学	教育
广州大学	教育
广西大学	教育
暨南大学	教育
武汉大学	教育
江南大学	教育
浙江大学	教育
深圳大学	教育
清华大学	教育
环球时代	教育
苏州大学	教育
西南大学	教育
贵州大学	教育
郑州大学	教育
重庆大学	教育
文亮专升本	教育
上海交通大学	教育
上海理工大学	教育
上海1_10大学	教育
中国人民大学	教育
中国矿业大学	教育
中央1_10大学	教育
北京交通大学	教育
北京师范大学	教育
华东师范大学	教育
华中科技大学	教育
华南理工大学	教育
南京理工大学	教育
合肥工业大学	教育
大连理工大学	教育
昆明理工大学	教育
武汉理工大学	教育
电子科技大学	教育
西南交通大学	教育
西南1_10大学	教育
西安交通大学	教育
中南1_10政法大学	教育
e人e本	数码
htc	数码
iphone	数码
iphone4	数码
iphone4s	数码
iphone5	数码
iphone5s	数码
iphone6	数码
iphone6plus	数码
iphone6s	数码
iphone7	数码
iuni	数码
ivvi	数码
koobee	数码
lg	数码
nubia	数码
oppo	数码
oppor1c	数码
oppor7	数码
oppor7plus	数码
tcl	数码
vivo	数码
vivox5	数码
vivox5m	数码
vivox5max	数码
vivox5pro	数码
yotaphone	数码
zuk	数码
中兴	数码
乐讯	数码
亿通	数码
华硕	数码
夏普	数码
天语	数码
奇酷	数码
威图	数码
朵唯	数码
纽曼	数码
联想	数码
华为 荣耀	数码
酷派	数码
金立	数码
魅族	数码
黑莓	数码
中兴axon	数码
三星galaxy	数码
苹果imac	数码
苹果macbook	数码
华为mate7	数码
华为mates	数码
多普达	数码
诺基亚	数码
飞利浦	数码
一加手机	数码
乐视手机	数码
小米手机	数码
摩托罗拉	数码
红米	数码
美图手机	数码
锤子手机	数码
魅蓝	数码
小辣椒手机	数码
索尼爱立信	数码
celine	时尚
chaumet	时尚
chloe	时尚
coach	时尚
dhc	时尚
dkny	时尚
fancl	时尚
gucci	时尚
loewe	时尚
lv	时尚
mikimoto	时尚
miumiu	时尚
prada	时尚
skii	时尚
tiffany	时尚
ysl	时尚
zenith	时尚
万国	时尚
伯爵	时尚
倩碧	时尚
兰芝	时尚
兰蔻	时尚
大宝	时尚
姬芮	时尚
娇兰	时尚
宝玑	时尚
宝珀	时尚
帝舵	时尚
梦妆	时尚
派克	时尚
浪琴	时尚
瓷肌	时尚
积家	时尚
美即	时尚
芬迪	时尚
薇姿	时尚
豪爵	时尚
豪雅	时尚
迪奥	时尚
雅漾	时尚
韩束	时尚
万宝龙	时尚
丝塔芙	时尚
丝芙兰	时尚
佰草集	时尚
劳力士	时尚
卡地亚	时尚
卡姿兰	时尚
妮维雅	时尚
娇韵诗	时尚
宝格丽	时尚
巴宝莉	时尚
御泥坊	时尚
植村秀	时尚
欧米茄	时尚
欧舒丹	时尚
欧诗漫	时尚
沛纳海	时尚
爱马仕	时尚
玉兰油	时尚
玫琳凯	时尚
珀莱雅	时尚
理肤泉	时尚
登喜路	时尚
百年灵	时尚
百雀羚	时尚
碧欧泉	时尚
科颜氏	时尚
美肤宝	时尚
自然堂	时尚
范思哲	时尚
贝玲妃	时尚
资生堂	时尚
阿玛尼	时尚
雪花秀	时尚
香奈儿	时尚
完美日用	时尚
巴黎世家	时尚
悦诗风吟	时尚
曼秀雷敦	时尚
杜嘉班纳	时尚
梵克雅宝	时尚
江诗丹顿	时尚
百达翡丽	时尚
相宜本草	时尚
菲拉格慕	时尚
菲诗小铺	时尚
蜜丝佛陀	时尚
雅诗兰黛	时尚
巴黎欧莱雅	时尚
美宝莲纽约	时尚
高丝雪肌精	时尚
伊丽莎白雅顿	时尚
boxster	汽车
c4毕加索	汽车
cayman	汽车
ds9	汽车
jeep吉普	汽车
macan	汽车
mg3	汽车
mini	汽车
multivan	汽车
pajun	汽车
panamera	汽车
passat	汽车
polo	汽车
qqme	汽车
rav4	汽车
taigun	汽车
tiguan	汽车
v3菱悦	汽车
x-bow	汽车
世嘉	汽车
丰田	汽车
乐风	汽车
乐驰	汽车
五菱	汽车
众泰	汽车
传祺	汽车
佳乐	汽车
傲虎	汽车
凌派	汽车
凌渡	汽车
凌特	汽车
凯尊	汽车
凯越	汽车
别克	汽车
力狮	汽车
北汽	汽车
卡宴	汽车
吉利	汽车
名图	汽车
名驭	汽车
君威	汽车
君越	汽车
启悦	汽车
启辰	汽车
嘉华	汽车
塞纳	汽车
夏朗	汽车
奇瑞	汽车
奇骏	汽车
奔奔	汽车
奔驰	汽车
奥拓	汽车
奥迪	汽车
威志	汽车
威航	汽车
威霆	汽车
威驰	汽车
威龙	汽车
宝威	汽车
宝来	汽车
宝马	汽车
宝骏	汽车
宾利	汽车
尚酷	汽车
帅客	汽车
帝威	汽车
帝豪	汽车
广汽	汽车
开迪	汽车
御翔	汽车
思域	汽车
思迪	汽车
悦翔	汽车
慕尚	汽车
捷豹	汽车
捷达	汽车
日产	汽车
昊锐	汽车
明仕	汽车
明锐	汽车
昕锐	汽车
晨风	汽车
景程	汽车
晶锐	汽车
智跑	汽车
朗动	汽车
朗境	汽车
朗行	汽车
朗逸	汽车
本田	汽车
杰德	汽车
标致	汽车
森雅	汽车
欧诺	汽车
欧陆	汽车
派喜	汽车
炫丽	汽车
玛驰	汽车
瑞奕	汽车
瑞纳	汽车
瑞虎	汽车
瑞风	汽车
睿翼	汽车
福特	汽车
秀尔	汽车
绅宝	汽车
缤智	汽车
翼神	汽车
翼虎	汽车
翼豹	汽车
英朗	汽车
荣威	汽车
荣御	汽车
菱智	汽车
蓝鸟	汽车
蝰蛇	汽车
西玛	汽车
贵士	汽车
赛欧	汽车
起亚	汽车
路宝	汽车
路虎	汽车
轩逸	汽车
辉腾	汽车
迈腾	汽车
远景	汽车
逍客	汽车
途安	汽车
途胜	汽车
途观	汽车
途锐	汽车
速派	汽车
速腾	汽车
速锐	汽车
逸致	汽车
野帝	汽车
铃木	汽车
锋范	汽车
锐志	汽车
锐欧	汽车
锐界	汽车
阁萝	汽车
雅致	汽车
雅阁	汽车
雅骏	汽车
雷凌	汽车
领翔	汽车
颐达	汽车
风雅	汽车
飞度	汽车
飞驰	汽车
驭胜	汽车
驰鹏	汽车
骊威	汽车
骏捷	汽车
骏逸	汽车
骐达	汽车
旗云1	汽车
宝马1系	汽车
宝马2系	汽车
荣威350	汽车
宝马3系	汽车
宝马3系gt	汽车
宝马4系	汽车
荣威550	汽车
宝马5系	汽车
宝马6系	汽车
宝骏730	汽车
宝马7系	汽车
宝马850i	汽车
丰田86	汽车
宝马8系	汽车
萨博95	汽车
荣威950	汽车
宝马9系	汽车
奥迪a1	汽车
奥迪a2	汽车
奥迪a3	汽车
奥迪a4l	汽车
奥迪a4	汽车
奇瑞a5	汽车
奥迪a5	汽车
奥迪a6	汽车
奥迪a6l	汽车
奥迪a6	汽车
奥迪a7	汽车
奥迪a8l	汽车
奥迪a8	汽车
奥迪a9	汽车
奥迪allroad	汽车
奔驰amg	汽车
丰田avalon	汽车
风神ax7	汽车
奔驰a级	汽车
奔驰a级amg	汽车
奔腾b50	汽车
奔腾b70	汽车
奔腾b90	汽车
奔驰b级	汽车
大众cc	汽车
奔驰cla级	汽车
奔驰cla级amg	汽车
奔驰clk	汽车
奔驰cls	汽车
奔驰cls级	汽车
风行cm7	汽车
本田cr-v	汽车
长安cs35	汽车
长安cs75	汽车
长安cx20	汽车
奔驰c级	汽车
奔驰c级amg	汽车
奔驰c级旅行	汽车
启辰d50	汽车
雷丁d70	汽车
奇瑞e3	汽车
荣威e50	汽车
逸动eado	汽车
帝豪ec7	汽车
莲花elise	汽车
别克encore	汽车
大众eos	汽车
花冠ex	汽车
奔驰e级	汽车
捷豹f-type	汽车
奔驰f400	汽车
奔驰f800	汽车
大众fox	汽车
瑞麒g6	汽车
传祺ga6	汽车
帝豪ge	汽车
奔驰gl	汽车
别克gl8	汽车
奔驰gla	汽车
奔驰glk	汽车
奔驰gl级amg	汽车
帝豪gt	汽车
日产gt-r	汽车
奔驰g级	汽车
奔驰g级amg	汽车
哈弗h2	汽车
幻速h2	汽车
哈弗h6	汽车
红旗h7	汽车
红旗hq3	汽车
宝马i3	汽车
现代i30	汽车
宝马i8	汽车
丰田iq	汽车
现代ix25	汽车
现代ix35	汽车
起亚k2	汽车
起亚k3	汽车
起亚k4	汽车
起亚k5	汽车
开瑞k50	汽车
起亚k9	汽车
起亚k900	汽车
起亚kx3	汽车
红旗l5	汽车
红旗l7	汽车
红旗l9	汽车
哈弗m1	汽车
瑞麒m1	汽车
哈弗m2	汽车
宝马m2	汽车
宝马m3	汽车
宝马m4	汽车
宝马m5	汽车
宝马m6	汽车
森雅m80	汽车
日产micra	汽车
林肯mkx	汽车
奔驰ml级	汽车
奔驰m级	汽车
宝马m级	汽车
奔驰m级amg	汽车
夏利n3	汽车
夏利n5	汽车
夏利n7	汽车
大众nms	汽车
日产nv200	汽车
奥迪q1	汽车
奥迪q2	汽车
奥迪q3	汽车
奥迪q4	汽车
奥迪q5	汽车
奥迪q6	汽车
奥迪q7	汽车
奥迪q8	汽车
奥迪q9	汽车
奇瑞qq	汽车
奥迪quattro	汽车
奥迪r10	汽车
启辰r30	汽车
大众r36	汽车
奥迪r4	汽车
启辰r50	汽车
奥迪r8	汽车
讴歌rl	汽车
和悦rs	汽车
奥迪rs3	汽车
奥迪rs4	汽车
奥迪rs5	汽车
奥迪rs6	汽车
奥迪rs7	汽车
奥迪rs8	汽车
奔驰r级	汽车
捷豹s-type	汽车
奥迪s1	汽车
奇瑞s18	汽车
奥迪s3	汽车
瑞风s3	汽车
奥迪s4	汽车
奥迪s5	汽车
海马s5	汽车
瑞风s5	汽车
奥迪s6	汽车
奥迪s7	汽车
奥迪s8	汽车
森雅s80	汽车
奔驰sl	汽车
奔驰slk	汽车
奔驰slr	汽车
奔驰sls	汽车
奔驰sls级amg	汽车
奔驰sl级amg	汽车
奔驰smart	汽车
铃木splash	汽车
奔驰s级	汽车
奔驰s级amg	汽车
众泰t600	汽车
启辰t70	汽车
奥迪tt	汽车
悦翔v3	汽车
威麟v5	汽车
悦翔v5	汽车
悦翔v7	汽车
长城v80	汽车
奔驰viano	汽车
奔驰vito	汽车
奔驰v级	汽车
宝马x1	汽车
宝马x2	汽车
宝马x3	汽车
宝马x4	汽车
宝马x5	汽车
陆风x5	汽车
宝马x6	汽车
陆风x6	汽车
宝马x7	汽车
宝马x8	汽车
陆风x8	汽车
奔腾x80	汽车
陆风x9	汽车
捷豹xf	汽车
捷豹xj	汽车
大众xl1	汽车
宝马z2	汽车
宝马z3	汽车
宝马z4	汽车
宝马z5	汽车
宝马z8	汽车
宝马z9	汽车
世纪星	汽车
亚洲龙	汽车
伊兰特	汽车
保时捷	汽车
凯美瑞	汽车
凯路威	汽车
利亚纳	汽车
劳恩斯	汽车
卡罗拉	汽车
唯雅诺	汽车
大捷龙	汽车
奥德赛	汽车
威赛帝	汽车
小贵族	汽车
帕萨特	汽车
思铂睿	汽车
指南者	汽车
捷恩斯	汽车
斯宾特	汽车
斯帕可	汽车
斯柯达	汽车
新天籁	汽车
昂科拉	汽车
昂科雷	汽车
普力马	汽车
普拉多	汽车
格蓝迪	汽车
桑塔纳	汽车
森林人	汽车
欧力威	汽车
歌诗图	汽车
比亚迪	汽车
毕加索	汽车
汉兰达	汽车
沃尔沃	汽车
法拉利	汽车
爱丽舍	汽车
爱唯欧	汽车
爱迪尔	汽车
牧马人	汽车
特斯拉	汽车
甲壳虫	汽车
福仕达	汽车
福克斯	汽车
福瑞达	汽车
福睿斯	汽车
福莱尔	汽车
科迈罗	汽车
科鲁兹	汽车
索纳塔	汽车
美人豹	汽车
自由舰	汽车
艾力绅	汽车
蒙派克	汽车
蒙迪欧	汽车
迈瑞宝	汽车
迈锐宝	汽车
阁瑞斯	汽车
雅力士	汽车
雅科仕	汽车
雅绅特	汽车
雪佛兰	汽车
雪铁龙	汽车
马自达	汽车
高尔夫	汽车
麦柯斯	汽车
马自达2	汽车
马自达3	汽车
保时捷356	汽车
法拉利458	汽车
马自达5	汽车
菲亚特500	汽车
马自达6	汽车
马自达8	汽车
保时捷911	汽车
保时捷918	汽车
斯巴鲁brz	汽车
雪铁龙c2	汽车
雪铁龙c3	汽车
沃尔沃c30	汽车
雪铁龙c4l	汽车
雪铁龙c5	汽车
比亚迪c6	汽车
雪铁龙c6	汽车
沃尔沃c70	汽车
雪铁龙c8	汽车
比亚迪e6	汽车
昂科威envision	汽车
法拉利enzo	汽车
比亚迪f0	汽车
比亚迪f1	汽车
比亚迪f3	汽车
比亚迪f6	汽车
比亚迪f8	汽车
比亚迪g3	汽车
比亚迪g3r	汽车
比亚迪g5	汽车
比亚迪g6	汽车
高尔夫gti	汽车
比亚迪i6	汽车
比亚迪l3	汽车
比亚迪l4	汽车
法拉利laferrari	汽车
比亚迪m6	汽车
西雅特mii	汽车
马自达mx-5	汽车
沃尔沃s40	汽车
比亚迪s6	汽车
沃尔沃s60	汽车
沃尔沃s60l	汽车
比亚迪s7	汽车
比亚迪s8	汽车
沃尔沃s80	汽车
沃尔沃s80l	汽车
迈巴赫s级	汽车
比亚迪t6	汽车
沃尔沃v40	汽车
沃尔沃v60	汽车
沃尔沃xc60	汽车
沃尔沃xc70	汽车
沃尔沃xc90	汽车
斯巴鲁xv	汽车
东风风神	汽车
五菱宏光	汽车
众泰知豆	汽车
克尔维特	汽车
全新胜达	汽车
兰博基尼	汽车
凯迪拉克	汽车
劳斯莱斯	汽车
双龙主席	汽车
吉利熊猫	汽车
奇瑞五娃	汽车
揽胜极光	汽车
普瑞维亚	汽车
林肯城市	汽车
欧菲莱斯	汽车
比亚迪唐	汽车
比亚迪秦	汽车
江南奥拓	汽车
江淮悦悦	汽车
海马爱尚	汽车
海马王子	汽车
玛莎拉蒂	汽车
索纳塔八	汽车
红旗旗舰	汽车
英菲尼迪	汽车
路虎卫士	汽车
路虎揽胜	汽车
进口迈腾	汽车
道奇公羊	汽车
长城精灵	汽车
陆风风华	汽车
陆风风尚	汽车
雷克萨斯	汽车
奇瑞风云2	汽车
东风标致2008	汽车
东风标致206	汽车
东风标致207	汽车
路虎发现3	汽车
东风标致3008	汽车
克莱斯勒300c	汽车
东风标致301	汽车
东风标致308	汽车
进口标致308cc	汽车
东风标致308s	汽车
进口宝马3系	汽车
路虎发现4	汽车
东风标致408	汽车
进口标致507	汽车
东风标致508	汽车
进口宝马5系	汽车
进口标致607	汽车
国产奥迪a3	汽车
进口奥迪a4	汽车
柯尼塞格agera	汽车
兰博基尼ankonian	汽车
凯迪拉克ats	汽车
兰博基尼aventador	汽车
一汽大众cc	汽车
玛莎拉蒂coupe	汽车
凯迪拉克cts	汽车
进口奔驰c级	汽车
凯迪拉克elr	汽车
雷克萨斯es	汽车
北京1_8e系	汽车
进口奔驰e级	汽车
上汽大通g10	汽车
玛莎拉蒂ghibli	汽车
北京奔驰glk	汽车
玛莎拉蒂grancabrio	汽车
玛莎拉蒂granturismo	汽车
雷克萨斯gs	汽车
雷克萨斯is	汽车
玛莎拉蒂kubang	汽车
雷克萨斯ls	汽车
英菲尼迪m	汽车
北汽威旺m20	汽车
玛莎拉蒂mc12	汽车
兰博基尼murcielago	汽车
英菲尼迪q30	汽车
进口奥迪q5	汽车
英菲尼迪q50	汽车
英菲尼迪q70l	汽车
兰博基尼reventon	汽车
凯迪拉克sls赛威	汽车
玛莎拉蒂spyder	汽车
凯迪拉克sts	汽车
上汽大通v80	汽车
国产宝马x1	汽车
凯迪拉克xts	汽车
丰田埃尔法	汽车
兰德酷路泽	汽车
别克新世纪	汽车
奥迪派克峰	汽车
帕萨特领驭	汽车
桑塔纳志俊	汽车
路虎神行者	汽车
路虎自由人	汽车
进口高尔夫	汽车
路虎神行者2	汽车
阿斯顿马丁one77	汽车
国产沃尔沃xc60	汽车
别克林荫大道	汽车
劳斯莱斯幻影	汽车
劳斯莱斯银魅	汽车
玛莎拉蒂总裁	汽车
兰博基尼爱马仕	汽车
劳斯莱斯古斯特	汽车
现代劳恩斯酷派	汽车
300英雄	游戏
3d坦克	游戏
cdc	游戏
cf穿越火线	游戏
deemo	游戏
dota2	游戏
jj斗地主	游戏
nba梦之队	游戏
nexon	游戏
qq三国	游戏
qq水浒	游戏
qq炫舞	游戏
qq飞车	游戏
q宠大乐斗	游戏
se中国	游戏
七杀	游戏
傲剑	游戏
剑灵	游戏
忍将	游戏
拳皇	游戏
数独	游戏
斩仙	游戏
枪魂	游戏
炫舞	游戏
烈焰	游戏
瑞趣	游戏
百游	游戏
神曲	游戏
神武	游戏
神魔	游戏
绿岸	游戏
网域	游戏
网龙	游戏
联众	游戏
腾讯	游戏
萌战	游戏
诛仙	游戏
逆战	游戏
问道	游戏
魔域	游戏
龙将	游戏
君王2	游戏
激战2	游戏
剑网3	游戏
天下3	游戏
三国kill	游戏
我叫mt	游戏
奇迹mu	游戏
世界ol	游戏
忘仙ol	游戏
恋舞ol	游戏
火影ol	游戏
蜀山ol	游戏
武侠q传	游戏
江南style骑马舞	游戏
怪物x联盟	游戏
三国杀	游戏
久游网	游戏
五子棋	游戏
仙侠道	游戏
冒险岛	游戏
割绳子	游戏
劲舞团	游戏
卧龙吟	游戏
大富翁	游戏
大将军	游戏
大掌门	游戏
对对碰	游戏
弹弹堂	游戏
悠游网	游戏
打豆豆	游戏
找你妹	游戏
捣蛋猪	游戏
掠夺者	游戏
摩力游	游戏
撸啊撸	游戏
斗地主	游戏
斗战神	游戏
新仙剑	游戏
星纪元	游戏
枪神纪	游戏
梦三国	游戏
梦天堂	游戏
泡泡堂	游戏
泡泡龙	游戏
猜歌王	游戏
神仙道	游戏
空中网	游戏
葫芦娃	游戏
魂斗罗	游戏
龙之谷	游戏
七雄争霸	游戏
三国战记	游戏
上古世纪	游戏
上海天游	游戏
世纪天成	游戏
九阴真经	游戏
二战风云	游戏
伙聚联合	游戏
传奇世界	游戏
传奇霸业	游戏
你画我猜	游戏
佣兵天下	游戏
保卫萝卜	游戏
傲世西游	游戏
傲视天地	游戏
光宇华夏	游戏
全民英雄	游戏
冰川网络	游戏
刀塔传奇	游戏
千橡互动	游戏
变形金刚	游戏
口袋战争	游戏
口袋精灵	游戏
合金弹头	游戏
啪啪三国	游戏
地铁跑酷	游戏
坦克世界	游戏
坦克大战	游戏
城堡争霸	游戏
多益网络	游戏
夜店之王	游戏
大周皇族	游戏
天书奇谈	游戏
天天酷跑	游戏
天天飞车	游戏
天空之舞	游戏
天龙八部	游戏
奇幻射击	游戏
女神联盟	游戏
如来神掌	游戏
完美世界	游戏
密室逃脱	游戏
小小帝国	游戏
崩坏学园	游戏
巨人网络	游戏
帝国崛起	游戏
幻想三国	游戏
广州新游	游戏
御龙在天	游戏
我是火影	游戏
战龙三国	游戏
捕鱼达人	游戏
搜狐畅游	游戏
攻城掠地	游戏
攻城略地	游戏
无尽之剑	游戏
时空猎人	游戏
昆仑万维	游戏
暴击僵尸	游戏
暴力摩托	游戏
暴雨1_3	游戏
杭州电魂	游戏
枪林弹雨	游戏
格斗之皇	游戏
梦幻西游	游戏
武神世纪	游戏
水果忍者	游戏
派讯1_3	游戏
海贼无双	游戏
消灭星星	游戏
深圳淘乐	游戏
1_7人生	游戏
1_7米果	游戏
火石软件	游戏
火线指令	游戏
炉石传说	游戏
炫舞时代	游戏
烈火战神	游戏
热血三国	游戏
热血江湖	游戏
狂斩三国	游戏
王者之剑	游戏
生存战争	游戏
瘟疫公司	游戏
登山赛车	游戏
神奇宝贝	游戏
神将世界	游戏
神州奥美	游戏
神庙逃亡	游戏
神雕侠侣	游戏
穿越火线	游戏
突击英雄	游戏
突击风暴	游戏
笑傲江湖	游戏
第九城市	游戏
联游网络	游戏
臻游网络	游戏
节奏大师	游戏
英雄传奇	游戏
英雄战魂	游戏
英雄联盟	游戏
英魂之刃	游戏
蓝港在线	游戏
蜗牛1_7	游戏
蜘蛛纸牌	游戏
街机三国	游戏
超级玛丽	游戏
逐鹿中原	游戏
造梦西游	游戏
部落战争	游戏
雷霆之怒	游戏
风云无双	游戏
飞机大战	游戏
骋龙1_7	游戏
骏梦1_7	游戏
魅影传说	游戏
魔兽世界	游戏
魔卡幻想	游戏
麒麟1_7	游戏
黄金矿工	游戏
黑暗之光	游戏
最终幻想14	游戏
大话西游2	游戏
忍者神龟2	游戏
神庙逃亡2	游戏
街头霸王2	游戏
天龙八部3	游戏
极品台球3	游戏
倩女幽魂ol	游戏
反恐精英ol	游戏
大闹天宫ol	游戏
火影忍者ol	游戏
笑傲江湖ol	游戏
俄罗斯方块	游戏
勇者大冒险	游戏
单机斗地主	游戏
哥哥帮帮忙	游戏
塔防三国志	游戏
大天使之剑	游戏
大家来找茬	游戏
大鱼吃小鱼	游戏
天天斗地主	游戏
天天爱消除	游戏
宠物小精灵	游戏
宠物连连看	游戏
开心水族箱	游戏
愤怒的小鸟	游戏
放开那三国	游戏
暗黑西游记	游戏
果蔬连连看	游戏
梦幻蛋糕店	游戏
梦想海贼王	游戏
欢乐斗地主	游戏
水果老虎机	游戏
水果连连看	游戏
波克斗地主	游戏
流星蝴蝶剑	游戏
混沌与秩序	游戏
滑雪大冒险	游戏
热血海贼王	游戏
燃烧的蔬菜	游戏
狂扁小朋友	游戏
画个火柴人	游戏
疯狂猜成语	游戏
百万亚瑟王	游戏
真人斗地主	游戏
跑跑卡丁车	游戏
会说话的金杰	游戏
地下城与勇士	游戏
拖拉机小1_7	游戏
撕开她的衣服	游戏
植物大战僵尸	游戏
疯狂小人战斗	游戏
皇帝成长计划	游戏
1_13大战老鼠	游戏
被尘封的故事	游戏
植物大战僵尸2	游戏
会说话的安吉拉	游戏
会说话的汤姆猫	游戏
暖暖的换装物语	游戏
神庙逃亡电脑版	游戏
范特西篮球经理	游戏
黄金矿工双人版	游戏
会说话的汤姆猫2	游戏
会说话的汤姆猫3	游戏
愤怒的小鸟太空版	游戏
搞怪碰碰球在线玩	游戏
鳄鱼小顽皮爱洗澡	游戏
植物大战僵尸无尽版	游戏
混沌与秩序之英雄战歌	游戏
biangbiang面	美食
东来顺	美食
俏江南	美食
毋米粥	美食
湘鄂情	美食
稻香村	美食
苏浙汇	美食
采蝶轩	美食
金汉斯	美食
风波庄	美食
鼎泰丰	美食
元气寿司	美食
巫山烤鱼	美食
广州酒家	美食
毛家饭店	美食
沙县小吃	美食
澳门豆捞	美食
诸葛烤鱼	美食
那家小馆	美食
阿瓦山寨	美食
青年餐厅	美食
麻辣诱惑	美食
东方饺子王	美食
单县羊肉汤	美食
唐宫海鲜舫	美食
喜家德水饺	美食
大清花饺子	美食
大渔铁板烧	美食
港式茶餐厅	美食
西贝莜面村	美食
上井日本料理	美食
争鲜回转寿司	美食
眉州东坡酒楼	美食
禾绿回转寿司	美食
老北京炸酱面	美食
康师傅私房牛肉面	美食
傅军	财经
冯仑	财经
叶檀	财经
水皮	财经
王卫	财经
王石	财经
秦晓	财经
胡润	财经
郁亮	财经
大成2020	财经
嘉实300	财经
易基50	财经
任志强	财经
刘军洛	财经
刘迎霞	财经
向华强	财经
吴敬琏	财经
孙正义	财经
宗庆后	财经
尚福林	财经
巴菲特	财经
常小兵	财经
张五常	财经
张近东	财经
曹德旺	财经
李书福	财经
李大霄	财经
杨受成	财经
杨怀定	财经
杨惠妍	财经
杨百万	财经
殷保华	财经
汤珈铖	财经
沙黾农	财经
潘石屹	财经
王东明	财经
王亚伟	财经
王健林	财经
王国强	财经
索罗斯	财经
董明珠	财经
褚时健	财经
许家印	财经
谢国忠	财经
邓文迪	财经
邵逸夫	财经
郎咸平	财经
金美欧	财经
陈光标	财经
霍英东	财经
马明哲	财经
黄光裕	财经
中银增长	财经
光大优势	财经
华夏优势	财经
华夏全球	财经
华夏回报	财经
华夏复兴	财经
华夏成长	财经
华夏红利	财经
华夏蓝筹	财经
华安创新	财经
华安策略	财经
华宝精选	财经
南方全球	财经
嘉实海外	财经
嘉实稳健	财经
大成价值	财经
大成蓝筹	财经
天弘精选	财经
富国天博	财经
广发聚丰	财经
招商先锋	财经
景顺平衡	财经
景顺精选	财经
添富均衡	财经
稻盛和夫	财经
诺安平衡	财经
诺安股票	财经
银华优选	财经
长信金利	财经
鹏华价值	财经
博时价值2号	财经
信诚四季红	财经
易方达科讯	财经
融通新蓝筹	财经
中海优质成长	财经
中邮核心优选	财经
中邮核心成长	财经
华商领先企业	财经
华夏现金增利	财经
博时价值增长	财经
博时新兴成长	财经
大成创新成长	财经
富国低碳环保	财经
工银核心价值	财经
长城安心回报	财经
南方现金增利a	财经
易方达价值成长	财经
上投摩根亚太优势	财经
58同城	互联网
雷军	互联网
马云	互联网
刘强东	互联网
周鸿祎	互联网
大街网	互联网
姚劲波	互联网
拉勾网	互联网
李学凌	互联网
李开复	互联网
李彦宏	互联网
猎聘网	互联网
赶集网	互联网
陆兆禧	互联网
马化腾	互联网
前程无忧	互联网
扎克伯格	互联网
智联招聘	互联网
bose	房产家居
jvc	房产家居
smeg	房产家居
三洋	房产家居
乐声	房产家居
九阳	房产家居
创佳	房产家居
创维	房产家居
博世	房产家居
容声	房产家居
方太	房产家居
春兰	房产家居
格力	房产家居
海信	房产家居
海尔	房产家居
长虹	房产家居
万利达	房产家居
格兰仕	房产家居
苏泊尔	房产家居
荣事达	房产家居
三体	文化生活
仙逆	文化生活
史记	文化生活
呐喊	文化生活
唐砖	文化生活
围城	文化生活
nba 2k	游戏
ds 5	汽车
苹果macbook air	数码
马自达6 atenza阿特兹	汽车
马自达3 axela昂克赛拉	汽车
hugo boss	时尚
雪铁龙gt concept	汽车
联想thinkpad e40	数码
联想thinkpad e420	数码
联想thinkpad e430	数码
兰博基尼sesto elemento	汽车
lady gaga	娱乐
marc jacobs	时尚
yaris l 致炫	汽车
ralph lauren	时尚
苹果mac mini	数码
苹果macbook pro	数码
model s	汽车
paul smith	时尚
coupe suv	汽车
harry winston	时尚
新闻	社会资讯
养花	文化生活
主播网红	娱乐
为人处世	文化生活
老毕	娱乐
天佑	娱乐
阿哲	娱乐
范特西	娱乐
雄安新区	社会资讯
河北雄安新区	社会资讯
卡塔尔 断交	社会资讯
卡塔尔 外交	社会资讯
科目三	汽车
科目二	汽车

